11111111111
10P00E00C01
11111111111