111111
1P0001
1C00E001
111111
