111111111111111111111111111111111111111111111111111111111
100000000000000000000000000000000000000000000000000000001
100000011111000000000000000000000C00000000000000000000001
100000010000000000000000000000000000000111100000000000001
100000010000000000001111111100000000000000100000000000001
100000000000000000000000000000000000000000000000100000001
100000000000C00000000000000000000000000000000000100000001
100000000000000000100000000000000000000000C00000000000001
10000001000000000010000000000P000000000000000000000000001
100000010000000000100000000000000000000000000000000000001
100000010000000000000000000000000000000000100000000000001
100000010000000000000000000000000000000000100000000010001
100000010000000000000000000000000000000000100000000010001
10000000000000000000000000000E000000000000100000000010001
100000000000000001000000000000000000000000000000000010001
100000C00000000001000000000000000000000000000000000010001
1000000000000000000000000C0000000000000000000000000000001
100000000000000000000000000000000000000000000000000000001
100000000000000000000000011111110000000000000000000000001
1000000000000000000000000000000000000000000000000C0000001
100000000000001000000000000000000000001000000000000000001
100000000000001000000000000000000000001000000000000000001
1000000000C00010000000000000C0000000001000000000000000001
100000000000001000000000000000000000001000000000000000001
100000000000001111110000000000000000001000000000000000001
100000100000000000000000000000000000000000000010000000001
10000010000000000000000000C000000000000000000010000000001
100000100000000000000000000000000000000000000010000000001
100000111100000000000001111111100000000000111110000000001
100000000000000000000000000000000000000000000000000000001
100000000000000000000000000000000000000000000000000000001
111111111111111111111111111111111111111111111111111111111
