1111111111111111111111111111111
1000000000000000000000000000001
100000C000000111110000000C00001
100E000000000100000000000000001
1000000000000100000000000001001
10000000000000P0000000000001001
1000000000000000000000000001001
1000011111000000000000000001001
1000010000000000000000000001001
100001000000000000000C000000001
1000010000000000000000000000001
1000000000000111110000000000001
1000000000000100000000000000001
10000C0000000100000000000000001
1000000000000100000000000000001
1000000000000100000011110000001
1000000000000100000010000000001
1000000000000000000010000000001
1000000000000000000010000000001
100000000000C000000010000000001
1000000000000000000000000000001
1000000000000000000000000C00001
1001000000000100000000000000001
1001000000000100000000000000001
1001000000000100000000100000001
1001000000000000000000100000001
100000000000000C000000100010001
1000000001000000000000100010001
1000000001000000000000000010001
1000000001000000000000000010001
1000000001000000000000000010001
1000000000000000000000000000001
10000C0000000000100000000000001
1000000000000000100000000000001
1000000000000000100000000000001
1000000000000000100000000000001
1000000000000000100000000000001
100000000000000000000000000C001
1000000000000000000000000000001
1000000000000000000000000000001
1000000100000000001000000000001
1000000100000000001000000000001
1000000100000C00001000000000001
1000000100000000001000000010001
1000000000000000000000000010001
1000000000000000000000000010001
1000000000000000000000000010001
100000000000000000000C000010001
1000000000000000000000000000001
1000010000000000000000000000001
1000010000000000000001111100001
1000010000000000000000000100001
1000010000C00000000000000100001
1000010000000000000000000100001
1000000000000000000000000000001
1000000000000000000000000000001
100000C000000000000000000C00001
1111111111111111111111111111111