1111111111111
10P000C000001
1000000000001
100000C000E01
100000C000001
100000C000001
1111111111111