1111111111111111111111
100000C000E0000C000011
10000P0000000000000001
1111111111111111111111